WWWWWWWWWWWWWWW          WWWWWWWWWWWWWWW
W                                      W
W                                      W
W                                      W
W             W                        W
W             W                        W
W                              R       W
W                                      W
W                                      W
W                                      W




                      T




W                                      W
W                        T             W
W                         T            W
W                          T           W
W                           T          W
W                            T         W
W                             T        W
W                                      W
W                                      W
W                                      W
WWWWWWWWWWWWWWW          WWWWWWWWWWWWWWW